????????????????????????????????????????????????E?????????????????????????????????????????????????????????????????????????????????????????????????????????????????????????????????????????????????????????????????????????????????????????????????????????????????????????EEEEE???????????????????????????EA
???????????????????????????????????????HHHHHHHHHE?????????????????????????????????????????????????????????????????????????????????????????????????????????????????????????????????????????????????????????????????????????????????????????????????????????????????????????E0E0E???????????????????????????EA
???????????????????????????????????????HHHHHHHH1E???????????????????????????????????????????????????????????????????????????????????????????????????????????????????????????????????????????????????????2?????????????????????????????????????????????????????????????????E0E0E???????????????????????????EA
????????????????????????????????????????????????E????????????????????????????????????????????????????????????????????????????????????????????????????????????????????????????????????????????2????????????????????????????????????????????????????????????????????????????E0E0E???????????????????????????EA
??????????????????????????????????????????eee???E????????????????????????????????????????????????????????????????????????????????????????????????????????????????????????????????????????????????AAAAA????????????????????????????????????????????????????????????????????E0E0E???????????????????????????EA
?????????????????????????030???????????EEEEEEEEEE???????????????????????????????????????????????????????????????????????????????????????????????????????????????????????????????????????????????AAAAAA????????????????????????????????????????????????????????????????????EEE0E???????????????????????????EA
???????????????????????????????????????E????????????????????????????????????????????????????????????????????????????????????????????????????????????EEE????????????????????????????????????????AAAAAAA??3???????????????????????????????????????????????????????????????????E0E???????????????????????????EA
???????????????????????????????????????E????????????????????????????????E??????E?????????????????????????????????????????????????????????????????????E?????????????????????????????????????????AAAAAAA??????????????????????????????????????????????????????????????????????E0E???????????????????????????EA
??HHH???HH???H???????????a?????????????E????????????????????????????????E002000E?????????????????????????????????????????????????????????????????????E?????????????????????????????????????????AAAAAAA??????????????????????????????????????????????????????????????????????E0E???????????????????????????EA
?H?????H??H??H????????EEEEBBBBBBBBBBB??E????????????????????????????????????????????????????????????????????????????????????????????????????????????????????????EEE??????????????????AAAAAAAAAAAAAAAAA??????????????????????????????????????????????????????????????????????EEE???????????????????????????EA
?H?????H??H??H???????EEEEE?????????????E???????????????????????????????????????????????????????????????????????????????????????????????????????????HHHH???????E?????????????????????AAAAAAAAAAAAAAAAAA??3?????????????????????????????????????????????????????????????????E???????????????????????????????EA
?H?HHH?H??H??H??????EEEEEE?????????????E?????????????????????????????????BBBBBB?????????????????????????????????????????????????????????????????e?????????????E????????????????????AAAAAAAAAAAAAAAAAAA????????????????????????????????????????????????????????????????????E???????????????????????????????EA
?H???H?H??H????????EEEEEEE?????????BBBBE???????HH????????????e???????????????????????????????????????????????E????????????????????????????????????????????????E???????????????????AAAAAAAAAAAAAAAAAAAA?????????????????????????????????????????????????????????????????????ZFFFFFFFFFFFFFFFFFFFFFFFFFFFFFFFF
??HHH???HH???H????EEEEEEEE?????????????E??????H??H??????????????????????????????????????????????????????EE???EE????????????????????????EEEEEE0????EEEEEEE?????EEE????????????????AAAAAAAAAAAAAAAAAAAAA??????????????????????????????????????????????????????????????????ZFFGGGGGGGGGGGGGGGGGGGGGGGGGGGGGGGGG
?????????????????EEEEEEEEE?????????????E?????H????H?????B00B00B1?B00B???????????????????EE??E?????a????EEE???EEE??????????????????????????????????????????????E????????????????AAAAAAAAAAAAAAAAAAAAAAA??2????????????????????????????????????????????????????????????ZFFGGGGGGGGGGGGGGGGGGGGGGGGGGGGGGGGGGGG
????????????????EEEEEEEEEEBBBBBBBBBBB??????????????????????????????????????????e???????EEE??EE????????EEEE???EEEE?????????????????????????????????????????O???E????????????????AAAAAAAAAAAAAAAAAAAAAAA????????????????????????????????????????????????????????????ZFFGGGGGGGGGGGGGGGGGGGGGGGGGGGGGGGGGGGGGGG
???????????????EEEEEEEEEEE????????????????????????????????????????????????????????????EEEE??EEE??????EEEEE???EEEEE????????????????????????????????????????N???E??????????????AAAAAAAAAAAAAAAAAAAAAAAAA?????????????????????????????????????????????????????????ZFFGGGGGGGGGGGGGGGGGGGGGGGGGGGGGGGGGGGGGGGGGG
??????????a???EEEEEEEEEEEE???????????????????E????E??????b???????a?a?a???????????????EEEEE??EEEE????EEEEEE???EEEEEE?????a?a?a?a?????E???b??aaaaaaaaa??????E???E?????????????AAAAAAAAAAAAAAAAAAAAAAAAAA??????????????????????????????????????????????????????ZFFGGGGGGGGGGGGGGGGGGGGGGGGGGGGGGGGGGGGGGGGGGGGG
FFFFFFFFFFFFFFFFFFFFFFFFFFFFFFFFFFFFFFFFFFFFFY????ZFFFFFFFFFFFFFFFFFFFFFFFFFFFFFFFFFFFFFFFFFFFFFFFFFFFFFFY???ZFFFFFFFFFFFFFFFFFFFFFFFFFFFFFFFFFFFFFFFFFFFFFFFFFFFFFFFFFFFFFFFFFFFFFFFFFFFFFFFFFFFFFFFFFFFFFFFFFFFFFFFFFFFFFFFFFFFFFFFFFFFFFFFFFFFFFFFFFFFFFFGGGGGGGGGGGGGGGGGGGGGGGGGGGGGGGGGGGGGGGGGGGGGGGG
GGGGGGGGGGGGGGGGGGGGGGGGGGGGGGGGGGGGGGGGGGGGG[????\GGGGGGGGGGGGGGGGGGGGGGGGGGGGGGGGGGGGGGGGGGGGGGGGGGGGGG[???\GGGGGGGGGGGGGGGGGGGGGGGGGGGGGGGGGGGGGGGGGGGGGGGGGGGGGGGGGGGGGGGGGGGGGGGGGGGGGGGGGGGGGGGGGGGGGGGGGGGGGGGGGGGGGGGGGGGGGGGGGGGGGGGGGGGGGGGGGGGGGGGGGGGGGGGGGGGGGGGGGGGGGGGGGGGGGGGGGGGGGGGGGGGGGG