???????????????????????????????????????????????????????????????????????????????????????????????????????????????????????????????????????????????????????????????????????????????????????????????P??????????????????????????????????PH?????????????????????????????E?????????????????????????????????????????E
???????????????????????????????????????????????????????????????????????????????????????????????????????????????????????????????????????????????????????????????????????????????????????????????P?2????????????????????????????????PH?????????????????????????????E?????????????????????????????????????????E
???????????????????????????????????????????????????????????????????????????????????????????????????????????????????????????????????????????????????????????????????????????????????????????????P??????HHH?????????????????????????PH?????????????????????????????E?????????????????????????????????????????E
??????????????????????????????????????????????????????EE???????????????????????????????????????????????????????????????????????????????????????????????????????????????????????????????????????P???EEEHHH?????????????????????????PH?????????????????????????????E?????????????????????????????????????????E
???????????????????????????????????????????????????????????????????????????????????????????????????????????????????????????????????????????????????????????????????????????????????????????????P??????HHH?????????????????????????PH?????????????????????????????E?????????????????????????????????????????E
???????????????????????????????????????????????????EE?22?EE????????????????????????????????????????????????????????????????????????????????????????????????????????????????????????????????????P????T?????????????????????????????PH?????????????????????????????E?????????????????????????????????????????E
???????????????????????????????????????????????????????????????????????????????????????????????????????????????????????????????????????????????????????????????????????????????????????????????P????U?????????????????????????????PH?????????????????????????????E?????????????????????????????????????????E
??????????????????????????????????????????????????????HHH???EE?????????????????????????????????????????????????????????????????????????????????????????????????????????????????????????????????PPPPPPP????????????????????????????PP?????????????????????????????E?????????????????????????????????????????E
??????????2?????????????????????????????????????EE?????e?????E???????????????????????????????????????????????????????????????????????????????????????????????????????????????????????????????????????PP???E??????????????????????????????????????????????????????E?????????????????????????????????????????E
????????HHHHH???????????????????EE???P?????i?????????????????EE??????????????????????????????????????????????????????????????????????????????????????????????????????????????????????????????????????????EE??????????????????????????????????????????????????????E?????????????????????????????????????????E
???????HHHHHHH???i?i?i?i?i??????EE?????????i???????EE?????????????????????????????????????????????????????????????????????????????????????????????????????????????????????????QQ????????????????????????EEE??????????????????????????????????????????????????????E?????????????????????????????????????????E
???????PPPPPPP???????P????????EEEE?????????i???????????????????????????????????????????????????EE????????????????????????????????????????????????????????????????????????????QQQ???????????????????????EEEE?EE????????????????????????????????????????EE?????????E?????????????????????????????????????????E
????????????????????????????EEEEEE?????????i??????????EE?????????????????????????e????????f????EEE??????????????????????????????????????????????????????????????????????????QQQQ????????????????????PPPEEEE????????????????????????????????EE????????????EE??????E?????????????????????????????????????????E
??????????????????????????EEEEEEEE?????????i???????????????????ZY???????????????HHH??????EEEE??EEEE??????????????????????????????????????????????????i?????????????????????QQQQQ??PP???????ddd?????????EEEE????????????????????????????EE????????????????????????E?????????????????????????????????????????E
????????????????????????EEEEEEEEEE?????????i?????????????EE????\[????????????????e??????EEEEE??EEEEE??????PP????PPP???????????????????????????PP??????????????????????????QQQQQQ??PPP?????????H233H????EEEE?????EE????????????????H3???????????????EE????????????E?????????????????????????????????????????E
??????????????????????EEEEEEEEEEEE?????????i???????????????????\[??????????????????????EEEEEE??EEEEEE?????PP????PPP???????????????????f???????PP????????????????????????QQQQQQQQ??PPPP????????HHHHH????EEEE?????????????????EE????HH???????????????????????EE????E?????????????????????????????????????????E
????????????????????EEEEEEEEEEEEEE?????????i???????????????????\[?????????????????????EEEEEEE??EEEEEEE????PP?????P??????????????f??????????????P????bb????????aa?????a????QQQQQQ??PPPPP?????????????PPPEEEE????????????????????????????????????EE??????????????????????????????????????????????????????????E
??????????????????EEEEEEEEEEEEEEEE?????????????????a???ZFFFFY??\[????????????????????EEEEEEEE??EEEEEEEE???PP?????P???????????b????f?????c??????PFFFFFFFFY???ZFFFFY???PP???QQQQQQ??PPPPPP???????????????EEEE???????????EE???????????????????????????????????????????????????????????????????????????????????E
FFFFFFFFFFFFFFFY???????????????????Q?ZFFFFFFFFFFFFFFY??\GGGG[??\[??ZFFFFFFFFFFFFFFFFFFFFFFFFY??ZFFFFFFFFFFPPPFFFFFFY??????ZFFFFFFFFFFFFFFFFFFFFFGGGGGGGGGFFFGGGGGGSSSSSSSSQQQQQQ??PPPPPPP????ZFFFFFFFYSSSSSSSSSSSSSSSSSSSSSSSSSSFFFFSSSSSSSSSSSSSSSSSSSSSSSSSFFFFFFFFFFFFFFFFFFFFFFFFFFFFFFFFFFFFFFFFFFFFFFF
GGGGGGGGGGGGGGG[?????????????????????\GGGGGGGGGGGGGG[??\GGGG[??\[??\GGGGGGGGGGGGGGGGGGGGGGGG[??\GGGGGGGGGGPPPGGGGGG[??QQ??\GGGGGGGGGGGGGGGGGGGGGGGGGGGGGGGGGGGGGGGSSSSSSSSQQQQQQ??PPPPPPPPSSS\GGGGGGGGS????SSSSSSSSSSSSSSSSSSSSSGGGGSSSSSSSSSSSSSSSSSSSSSSSSSGGGGGGGGGGGGGGGGGGGGGGGGGGGGGGGGGGGGGGGGGGGGGGG