????????????????????????????????????????????????E???????????????????????????????????????????????????????????????????????????????????????????????????????????????????????????????????????????A????????A??????????????????????????????????????????????????????????????????????????????????????????????????????
???????????????????????????????????????HHHHHHHHHE???????????????????????????????????????????????????????????????????????????????????????????????????????????????????????????????????????????A???????AA??????????????????????????????????????????????????????????????????????????????????????????????????????
???????????????????????????????????????HHHHHHHH1E???????????????????????????????????????????????????????????????????????????????????????????????????????????????????????????????????????????A??????AAA??????????????????????????????????????????????????????????????????????????????????????????????????????
????????????????????????????????????????????????E???????????????????????????????????????????????????????????????????????????????????????????????????????????????????????????????????????????A0????AAAA??????????????????????????????????????????????????????????????????????????????????????????????????????
??????????????????????????????????????????eee???E???????????????????????????????????????????????????????????????????????????????????????????????????????????????????????????????????????????A????AAAAA??????????????????????????????????????????????????????????????????????????????????????????????????????
?????????????????????????030???????????EEEEEEEEEE???????????????????????????????????????????????????????????????????????????????????????????????????????????????????????????????????????????A???AAAAAA??????????????????????????????????????????????????????????????????????????????????????????????????????
???????????????????????????????????????E????????????????????????????????????????????????????????????????????????????????????????????????????????????EEE?????????????????????????????????????A??AAAAAAA??????????????????????????????????????????????????????????????????????????????????????????????????????
???????????????????????????????????????E????????????????????????????????E??????E?????????????????????????????????????????????????????????????????????E??????????????????????????????????????A?AAAAAAAA??????????????????????????????????????????????????????????????????????????????????????????????????????
??HHH???HH???H???????????a?????????????E????????????????????????????????E002000E?????????????????????????????????????????????????????????????????????E??????????????????????????????????????AAAAAAAAAA??????????????????????????????????????????????????????????????????????????????????????????????????????
?H?????H??H??H????????EEEEBBBBBBBBBBB??E????????????????????????????????????????????????????????????????????????????????????????????????????????????????????????EEE??????????????????AAAAAAAAAAAAAAAAA??????????????????????????????????????????????????????????????????????????????????????????????????????
?H?????H??H??H???????EEEEE?????????????E???????????????????????????????????????????????????????????????????????????????????????????????????????????HHHH???????E?????????????????????AAAAAAAAAAAAAAAAAA??????????????????????????????????????????????????????????????????????????????????????????????????????
?H?HHH?H??H??H??????EEEEEE?????????????E?????????????????????????????????BBBBBB?????????????????????????????????????????????????????????????????e?????????????E????????????????????AAAAAAAAAAAAAAAAAAA??????????????????????????????????????????????????????????????????????????????????????????????????????
?H???H?H??H????????EEEEEEE?????????BBBBB???????HH????????????e???????????????????????????????????????????????E????????????????????????????????????????????????E???????????????????AAAAAAAAAAAAAAAAAAAA??????????????????????????????????????????????????????????????????????????????????????????????????????
??HHH???HH???H????EEEEEEEE?????????????E??????H??H??????????????????????????????????????????????????????EE???EE????????????????????????EEEEEE0????EEEEEEE?????E??????????????????AAAAAAAAAAAAAAAAAAAAA??????????????????????????????????????????????????????????????????????????????????????????????????????
?????????????????EEEEEEEEE?????????????E?????H????H?????B00B00B1?B00B???????????????????EE??E?????a????EEE???EEE??????????????????????????????????????????????E????????????????AAAAAAAAAAAAAAAAAAAAAAA??????????????????????????????????????????????????????????????????????????????????????????????????????
????????????????EEEEEEEEEEBBBBBBBBBBB??????????????????????????????????????????e???????EEE??EE????????EEEE???EEEE?????????????????????????????????????????O???E????????????????AAAAAAAAAAAAAAAAAAAAAAA??????????????????????????????????????????????????????????????????????????????????????????????????????
???????????????EEEEEEEEEEE????????????????????????????????????????????????????????????EEEE??EEE??????EEEEE???EEEEE????????????????????????????????????????N???E??????????????AAAAAAAAAAAAAAAAAAAAAAAAA??????????????????????????????????????????????????????????????????????????????????????????????????????
??????????a???EEEEEEEEEEEE???????????????????E????E??????b???????a?a?a???????????????EEEEE??EEEE????EEEEEE???EEEEEE?????a?a?a?a?????E???b??aaaaaaaaa??????E???E?????????????AAAAAAAAAAAAAAAAAAAAAAAAAA??????????????????????????????????????????????????????????????????????????????????????????????????????
FFFFFFFFFFFFFFFFFFFFFFFFFFFFFFFFFFFFFFFFFFFFFY????ZFFFFFFFFFFFFFFFFFFFFFFFFFFFFFFFFFFFFFFFFFFFFFFFFFFFFFFY???ZFFFFFFFFFFFFFFFFFFFFFFFFFFFFFFFFFFFFFFFFFFFFFFFFFFFFFFFFFFFFFAAAAAAAAAAAAAAAAAAAAAAAAAAAFFFFFFFFFFFFFFFFFFFFFFFFFFFFFFFFFFFFFFFFFFFFFFFFF?????????????????????????????????????????????????????
GGGGGGGGGGGGGGGGGGGGGGGGGGGGGGGGGGGGGGGGGGGGG[????\GGGGGGGGGGGGGGGGGGGGGGGGGGGGGGGGGGGGGGGGGGGGGGGGGGGGGG[???\GGGGGGGGGGGGGGGGGGGGGGGGGGGGGGGGGGGGGGGGGGGGGGGGGGGGGGGGGGGGGGGGGGGGGGGGGGGGGGAGGGGGGGGAGGGGGGGGGGGGGGGGGGGGGGGGGGGGGGGGGGGGGGGGGGGGGGGGGGGGGGGGGGGGGGGGGGGGGGGGGGGGGGGGGGGGGGGGGGGGGGGGGGGGGG