????????????????????????????????????????????????????????????????????????????????????????????????????????????????????????????????????????????????????????????????????????????????????????????????????????????????????????????????????????????????????????????????????EEEEEEEEEEEEEEEEEEEEEEEEEEEEEEEEEEEEEEEE
?????????????????????????????????????????????????????????????????????????????????????????????????????????????????????????????????????????EEEEEEEEEEEEEEEEEEEEE??????????????????????????????????????????????????????????????????????????????????????????????????????EEEEEEEEEEEEEEEEEEEEEEEEEEEEEEEEEEEEEEEE
??????????????????????????????????????????????????????????????????????????????????????????????????????????????????????EE??EEE???EE???????E???????????????????E??????????????????????????????????????????????????????????????????????????????????????????????????????EEEEEEEEEEEEEEEEEEEEEEEEEEEEEEEEEEEEEEEE
??????????????????????????????????????aaa????????????????????????????????????????????????????????????????????????????????????????????????E???????????????????E??????????????????????????????????????????????????????????????????????????????????????????????????????EEEEEEEEEEEEEEEEEEEEEEEEEEEEEEEEEEEEEEEE
??????????????????????????????EEEEEEEEEEEEEEE???EEEEEEEEEEEEEEEEEEEEEEEEEEEEEEEEEEEEEEEEEEEEEEEEEEEEEEEEEEEEEEE??EE??HH?eH?eH?H??H???????EEEEEEEEEEEEEEEEEEEEEEEEEEEEEEEEEEEEEEEEEEEEEEEEEEEEEEEEEEEEEEEEE????????????????????????????????????????????????????????????EEEEEEEEEEEEEEEEEEEEEEEEE??EEEEEEEEEEE
??????????????????????????????E?????????????EE??EH???HHHB??????EEE???????????????????????????????????????????EE??E??H???H?H?H?HH?H??EE???EEEEEEEEEEEEEEEEEEEEEEE?????????????????????????????????????????E??????????????????????????????????????????????????????????????EEEEEEEEEEEEEEEEEEEEE????EEEEEEEEEEE
??????????????????????????????E?????????????????EH???HHHB???????EEEEEEEEEEEEEEEEEEEEEEEEE??????????????????????EEE??H???HeHiHeH?HH??EE????????????????????????EEEEEEEEEEEEEEEEEEEEEEEEEEEEEEEEEEEEEEEEEEEE????????????????????????????????????????????????????????????????EEEEEEEEEEEEEEEEE??????EEEEEEEEEEE
EEEEEEEEEEEEE??EEEEEEEEEE?????E????????????????EE????HHHB???????EEEEEEEEE??????????????EE??????????????????????EEE???HH??H??H?H??H????????????????????????????????????????????????????????EEEEEEEEEEEEEEEE??????????????????????????????????????????????????????????????????EEEEEEEEEEEEE????????EEEEEEEEEEE
EEEEEEEEEEEEE??EEEEEEEEEE?????E???????????????EE???E?HHHB????????EEEEE?????????????????EEEEEEEEEEEEEEEEEEEEEEEEEEE??????????????????????????????????????????????????????????????????????????????????????EE????????????????????????????????????????????????????????????????????EEEEEEEEE??????????EEEEEEEEEEE
EEEEEEEEEEEHHHEEEEEEEE??????HHE??????????????EE??????HHHB????ee?????????????????????HHHHH????????????????????????????????????????E??????EE??????????????????????????????????????????????????????????????EE????????????EE????????????????????????????????????????????EE??????????EEEEE????????????EEEEEEEEEEE
E?????????EHHHEEEEEEEE?????EHHE?????????????EE???????HHHB???HHHH????????????????????ee?????????HHHHHH??????????????????EEE??????EE??????????????????????????????????????????????????????????????????????EE??????????EEEEE??????????????????????????????????????????EEE????????????E??????????????EEEEEEEEEEE
E?????????EHHHE??????????EEEHHEEEEBBBB?????EE??????E?HHHB??????????????????????????????????????HHHHHH????????i?????????????????????????????????????????????????????????????????????a????????????????????EE??????????EEEEE?????????????????????????????????????????EEEEEE?????????????????????????EEEEEEEEEEE
E?????????EHHHE??????????????????????BBBBBEE?????????HHHB?????????????????????321????????????E????????E????????i????????????????????????????????????????????????LE??????????E???EEEEEEE?????????????????EE????????EEEEEEEE???????????????????????????????????????EEEEEEE?????????????????????????EEEEEEEEEEE
E?????????EEEEE???HHHH??????????????????BB???????B??????B????????????????????????????????????E???aa???E?????????????????????EE???????EE????????????????????????LEE??????????E???EEEEEEE???????????????????????????EE?EEEEE??????????????????????????????????????EEEEEEEE?????????????????????????EEEEEEEEEEE
E????????????????????e?????????????????BB??????BBBBBBBBBB???????????????????????????????????EEEEEEEEEEE??????????????????????????????EE????????????????????????EEE???HHH????E???EEEEEEE?????EE??????????????????EEE???EEEEE????????????????????????????????????EEEEEEEEEE????????????????????????EEEEEEEEEEE
E????????????????B0B12B3B??????c??????BB???????????????????????????????????????a???????????????????????????????33???????????????EE????????EE??????????????????EEEE????e????EEE??EEEEEEEEE??EEE?????????EEE??????EEEE?EEEEEE??????????????????????????????????EEEEEEEEEEEE????????????????????????EEEEEEEEEEE
E???????????????????????????EEEEEE??????????????????????????????????????????EEEEEEE?????????????????????????????????????EE??????EE????????EEE????????????????EE?EE????????EEE????HHHHHHHEEEEEE?????????EEE????EEEEEE?EEEEEEE????????????????????????????????????????EEEEE????????????????????????EEEEEEEEEEE
E?????????EEEEE????HHHH????EEEEEEEE?????????a??????????????????????EEEEEE???EE???EE???????aa????aa?????aa?????????????????????????????????EEEE????aaaa??????EE???EE?????EEE?E????HHHHHHHEEEEEE???aa???EEEE????EEEEEEEEEEEEEE????????????????????????????????????????EEEEEE???????????????????????EEEEEEEEEEE
EEEEEEEEEEEEEEEE????aaa???EEEEEEEEEEEEEEEEEEEEEEEEEEEEEEEEEEEEEE???E????E??EEE???EE??EEEEEEEEEEEEEEEEEEEEEEEE???????EE??????????????EE????EEEEEEEEEEEEEEEEEEEEE?EEEE???EE???E???????a???EEEEEEEEEEEEEEEEEEEEEEEEEEEEEEEEEEEEEEEEEEEEEEEEEEEEEEEEEEEEEEEEEEEEEEEEEEEEEEEEEEEEEEEEEEEEEEEEEEEEEEEEEEEEEEEEEEEE
EEEEEEEEEEEEEEEEEEEEEEEEEEEEEEEEEEEEEEEEEEEEEEEEEEEEEEEEEEEEEEEE???E????E??EEEEEEEE??EEEEEEEEEEEEEEEEEEEEEEEE??EE??EEE??????????????EE????EEEEEEEEEEEEEEEEEEEEEEEEEEE??EEEEEEEE??EEEEEEEEEEEEEEEEEEEEEEEEEEEEEEEEEEEEEEEEEEEEEEEEEEEEEEEEEEEEEEEEEEEEEEEEEEEEEEEEEEEEEEEEEEEEEEEEEEEEEEEEEEEEEEEEEEEEEEEEEEE